					NO	./textures/NO.xpm
SO ./textures/SO.xpm
WE ./textures/WE.xpm
EA ./textures/EA.xpm

C 0,100,255
F 220,100,0


11111111111111111111111111
10000000000000000000000001
10000000000000000000000001
10000000000000000000000001
10000000000000000000000001
10000000000000000000100001
100000000000000000N10000011111
100000000000000000N10000000000111111111111
10000000000000000000000001111111111111111
1000000000000000000000000011111111111111111111111111111
10000000001111111111111111111111111111111111111
1111111111

