NO	./textures/NO.xpm

SO ./textures/SO.xpm

WE ./textures/WE.xpm

EA ./textures/EA.xpm


F 220,100,0


C 225,30,0



111111
100101S
101001
110001
111111



